###################
#.#.......#......A#
#.#.#####.#.#####.#
#.#.....#.#.....#.#
#.#####.#.#.#####.#
#.....#.....#.....#
#####.#####.#####.#
#.....#.....#.....#
#.#####.#####.#####
#.....#.....#.....#
#####.#.#####.#####
#...#.....#.....#.#
#.#.#####.#.#####.#
#.#.....#.#.....#.#
#.#####.#.#.#####.#
#P......#.#.......#
#####.#.#E#.#.#####
#.....#.....#.....#
###################
